....................
...G............X...
...--..G.......--...
....G.--........G...
...--..........--...
...G......G....G....
...--....--....--...
....G...........G...
...--........G.--...
...G........--.G....
...--..........--...
....G...........G...
...--..........--...
.1.......B..........
####################
